################################
#..............................#
#..............................#
#..............................#
#..............................#
#..............@...............#
#..............................#
#..............................#
#..............................#
#..............................#
#..............................#
################################
