################
#..............#
#..............#
#.....###......#
#..............#
#.........###..#
#..###.........#
#..............#
#.........###..#
#..##..........#
#......@.......#
################
