################
#..............#
#..............#
#######.########
#..............#
########.#######
#..............#
##############.#
#..............#
#.##############
#......@.......#
################
